12
16
1 5
10 14
8 9 4 10 9 6
10 3 10 4 3 1 3 2 6 10 6 13 6 14 8 7
2 2 2 2 2 2 2 2 2 2 2 2 2 2 2 2
2 0 0 0 0 0 0 0 0 0 0 2 0 0 0 2
2 0 0 0 0 0 0 0 0 0 0 2 0 0 0 2
2 0 0 0 0 0 0 0 0 0 0 2 0 0 0 2
2 2 2 0 0 2 0 0 0 0 0 0 0 0 0 2
2 0 0 0 0 2 0 0 2 2 2 2 0 0 0 2
2 0 0 2 2 2 0 0 0 0 0 0 0 0 0 2
2 0 0 0 0 2 2 2 0 0 2 0 0 2 2 2
2 2 0 0 0 2 0 0 0 0 0 0 0 0 0 2
2 2 2 0 0 2 0 2 0 0 0 0 0 0 0 2
2 2 2 0 0 2 0 2 2 2 2 0 0 0 0 2
2 2 2 2 2 2 0 2 2 2 2 0 2 2 2 2
